"","Parcel","Year","Date","Tran_Name","Species","Green","Live","Hit"
"1","PLC219",2022,2022-07-28,"5","SAVE4",8,5,13
"2","PLC219",2022,2022-07-28,"54","SAVE4",4,2,6
"3","PLC219",2022,2022-07-28,"54","ATCO",2,0,2
"4","PLC219",2022,2022-07-28,"23","SAVE4",3,1,4
"5","PLC219",2022,2022-07-28,"23","ATCO",1,0,1
"6","PLC219",2022,2022-07-28,"23","SPAI",10,0,10
"7","PLC219",2022,2022-07-28,"23","MACA17",6,0,6
"8","PLC219",2022,2022-07-28,"45","SAVE4",7,3,10
"9","PLC219",2022,2022-07-28,"45","ATCO",2,1,3
"10","PLC219",2022,2022-07-28,"45","SPAI",3,0,3
"11","PLC219",2022,2022-07-28,"45","MACA17",2,0,2
"12","PLC219",2022,2022-07-28,"66","SAVE4",8,5,13
"13","PLC219",2022,2022-07-28,"66","ATCO",1,0,1
"14","PLC219",2022,2022-07-28,"37","SAVE4",11,2,13
"15","PLC219",2022,2022-07-28,"37","ATCO",2,1,3
"16","PLC219",2022,2022-07-28,"46","SAVE4",1,0,1
"17","PLC219",2022,2022-07-28,"46","ATTO",5,4,9
"18","PLC219",2022,2022-07-28,"46","ERIOG",1,0,1
"19","PLC219",2022,2022-07-28,"46","ATPO",1,1,2
"20","PLC219",2022,2022-07-28,"22","SAVE4",10,2,12
"21","PLC219",2022,2022-07-28,"22","ATCO",3,0,3
"22","PLC219",2022,2022-07-28,"22","ATPO",0,2,2
"23","PLC219",2022,2022-07-28,"30","ATTO",12,5,17
"24","PLC219",2022,2022-07-28,"30","ERIOG",1,0,1
"25","PLC219",2022,2022-07-28,"30","ATPO",7,0,7
"26","PLC219",2022,2022-07-28,"71","SAVE4",10,3,13
"27","PLC219",2022,2022-07-28,"71","ATCO",2,0,2
"28","PLC219",2022,2022-07-28,"71","SUMO",1,0,1
"29","PLC219",2022,2022-07-28,"20","SAVE4",10,2,12
"30","PLC219",2022,2022-07-28,"20","MACA17",1,0,1
"31","PLC219",2022,2022-07-28,"43","SAVE4",11,5,16
"32","PLC219",2022,2022-07-28,"43","ATCO",1,1,2
"33","PLC219",2022,2022-07-28,"43","SUMO",8,0,8
"34","PLC219",2022,2022-07-28,"27","SAVE4",7,4,11
"35","PLC219",2022,2022-07-28,"27","MACA17",1,0,1
"36","PLC219",2022,2022-07-28,"27","SUMO",2,1,3
"37","PLC219",2022,2022-07-28,"27","ATCO",1,0,1
"38","PLC219",2022,2022-07-28,"82","SAVE4",1,1,2
"39","PLC219",2022,2022-07-28,"82","ATCO",3,1,4
"40","PLC219",2022,2022-07-28,"82","ATTO",0,1,1
"41","PLC219",2022,2022-07-28,"82","ERIOG",1,0,1
"42","PLC219",2022,2022-07-28,"82","SPAI",1,0,1
"43","PLC219",2022,2022-07-28,"70","SAVE4",7,2,9
"44","PLC219",2022,2022-07-28,"70","MACA17",2,0,2
"45","PLC219",2022,2022-07-28,"70","ATTO",2,0,2
"46","PLC219",2022,2022-07-28,"70","SPAI",4,0,4
"47","PLC219",2022,2022-07-28,"70","ERNA10",8,2,10
"48","PLC219",2022,2022-07-28,"70","DISP",1,0,1
"49","PLC219",2022,2022-07-28,"52","SAVE4",8,5,13
"50","PLC219",2022,2022-07-28,"52","ATCO",1,1,2
"51","PLC219",2022,2022-07-28,"44","SAVE4",6,2,8
"52","PLC219",2022,2022-07-28,"44","MACA17",1,0,1
"53","PLC219",2022,2022-07-28,"44","ATCO",5,2,7
"54","PLC219",2022,2022-07-27,"6","ATCO",2,0,2
"55","PLC219",2022,2022-07-27,"6","ERNA10",0,1,1
"56","PLC219",2022,2022-07-27,"6","SAVE4",5,4,9
"57","PLC219",2022,2022-07-27,"6","SUMO",0,1,1
"58","PLC219",2022,2022-07-27,"6","MACA17",1,0,1
"59","PLC219",2022,2022-07-27,"21","ATCO",1,1,2
"60","PLC219",2022,2022-07-27,"21","ARTR2",1,0,1
"61","PLC219",2022,2022-07-27,"21","SAVE4",3,3,6
"62","LAW029",2022,2022-07-25,"5","ATCO",3,0,3
"63","LAW029",2022,2022-07-25,"5","SAVE4",4,0,4
"64","LAW029",2022,2022-07-25,"5","ATCA2",1,0,1
"65","LAW029",2022,2022-07-25,"15","SAVE4",7,3,10
"66","LAW029",2022,2022-07-25,"15","ATCO",1,0,1
"67","LAW029",2022,2022-07-25,"19","SAVE4",4,1,5
"68","LAW029",2022,2022-07-25,"19","ATCO",2,0,2
"69","LAW029",2022,2022-07-25,"19","ATCA2",2,1,3
"70","LAW029",2022,2022-07-25,"19","SATR12",2,0,2
"71","LAW029",2022,2022-07-25,"6","SAVE4",9,3,12
"72","LAW029",2022,2022-07-25,"6","SUMO",3,0,3
"73","LAW029",2022,2022-07-25,"16","ATCO",2,3,5
"74","LAW029",2022,2022-07-25,"16","ATTO",4,2,6
"75","LAW029",2022,2022-07-25,"16","ERNA10",3,0,3
"76","LAW029",2022,2022-07-25,"10","ATTO",5,5,10
"77","LAW029",2022,2022-07-25,"10","DISP",9,7,16
"78","LAW029",2022,2022-07-25,"22","ATTO",8,3,11
"79","LAW029",2022,2022-07-25,"22","ALOC2",3,0,3
"80","LAW029",2022,2022-07-25,"22","ERNA10",1,2,3
"81","LAW029",2022,2022-07-25,"22","DISP",1,0,1
"82","LAW029",2022,2022-07-25,"1","ATTO",2,1,3
"83","LAW029",2022,2022-07-25,"1","ERNA10",7,0,7
"84","LAW029",2022,2022-07-25,"1","DISP",7,5,12
"85","LAW029",2022,2022-07-25,"11","ATTO",10,5,15
"86","LAW029",2022,2022-07-25,"14","ATTO",8,2,10
"87","LAW029",2022,2022-07-25,"14","ERNA10",6,0,6
"88","LAW029",2022,2022-07-25,"17","SUMO",2,0,2
"89","LAW029",2022,2022-07-25,"17","SAVE4",1,0,1
"90","LAW029",2022,2022-07-25,"7","SUMO",3,0,3
"91","LAW029",2022,2022-07-25,"7","ATCO",4,0,4
"92","LAW029",2022,2022-07-25,"7","SAVE4",2,2,4
"93","LAW029",2022,2022-07-25,"7","ATTO",1,1,2
"94","LAW029",2022,2022-07-25,"2","ATCO",0,2,2
"95","LAW029",2022,2022-07-25,"2","SAVE4",9,1,10
"96","LAW029",2022,2022-07-25,"2","ATTO",6,1,7
"97","LAW029",2022,2022-07-25,"18","SAVE4",2,1,3
"98","LAW029",2022,2022-07-25,"24","ATCO",5,1,6
"99","LAW029",2022,2022-07-25,"24","SAVE4",1,1,2
"100","LAW029",2022,2022-07-25,"23","ATCO",4,4,8
"101","LAW029",2022,2022-07-25,"23","SATR12",1,0,1
"102","LAW029",2022,2022-07-25,"25","SATR12",0,1,1
"103","LAW029",2022,2022-07-25,"25","ATCO",4,1,5
"104","LAW029",2022,2022-07-25,"25","SAVE4",1,0,1
"105","LAW029",2022,2022-07-25,"13","ATCO",5,1,6
"106","LAW029",2022,2022-07-25,"13","SATR12",1,0,1
"107","LAW029",2022,2022-07-25,"9","SAVE4",3,0,3
"108","LAW029",2022,2022-07-25,"9","ATTO",3,2,5
"109","LAW029",2022,2022-07-25,"9","SUMO",1,0,1
"110","LAW029",2022,2022-07-25,"21","ATCO",3,1,4
"111","LAW029",2022,2022-07-25,"21","ATTO",2,1,3
"112","LAW029",2022,2022-07-25,"21","SATR12",1,0,1
"113","LAW119",2023,2023-08-05,"53","ERIOG",2,0,2
"114","LAW119",2023,2023-08-05,"53","SATR12",6,0,6
"115","LAW119",2023,2023-08-05,"53","ERNA10",4,1,5
"116","LAW119",2023,2023-08-05,"22","ERIOG",2,0,2
"117","LAW119",2023,2023-08-05,"22","SATR12",2,0,2
"118","LAW119",2023,2023-08-05,"22","ERNA10",5,5,10
"119","LAW119",2023,2023-08-05,"17","SATR12",4,0,4
"120","LAW119",2023,2023-08-05,"17","ERNA10",6,12,18
"121","LAW119",2023,2023-08-05,"12","ERNA10",2,1,3
"122","LAW119",2023,2023-08-05,"12","SPAI",22,0,22
"123","LAW119",2023,2023-08-05,"12","IVAX",4,0,4
"124","LAW119",2023,2023-08-05,"12","ELEOC",14,0,14
"125","LAW119",2023,2023-08-05,"12","COCA5",3,0,3
"126","LAW119",2023,2023-08-05,"12","PACA6",14,0,14
"127","LAW119",2023,2023-08-05,"12","LELA2",3,0,3
"128","LAW119",2023,2023-08-05,"12","EPCI",4,0,4
"129","LAW119",2023,2023-08-05,"12","BAHY",7,0,7
"130","LAW119",2023,2023-08-05,"12","HEAN3",3,0,3
"131","LAW119",2023,2023-08-05,"12","JUARL",1,0,1
"132","LAW119",2023,2023-08-05,"12","SAVE4",0,2,2
"133","LAW119",2023,2023-08-05,"10","ATTO",4,8,12
"134","LAW119",2023,2023-08-05,"10","SAVE4",8,4,12
"135","LAW119",2023,2023-08-05,"10","BAHY",2,0,2
"136","LAW119",2023,2023-08-05,"10","ERNA10",3,4,7
"137","LAW119",2023,2023-08-05,"10","ATCO",0,2,2
"138","LAW119",2023,2023-08-05,"10","IVAX",3,0,3
"139","LAW119",2023,2023-08-05,"10","DISP",2,0,2
"140","LAW119",2023,2023-08-05,"10","CAREX",5,0,5
"141","LAW119",2023,2023-08-05,"10","CYDA",2,0,2
"142","LAW119",2023,2023-08-05,"10","TYLA",1,0,1
"143","LAW119",2023,2023-08-05,"44","ATTO",2,3,5
"144","LAW119",2023,2023-08-05,"44","MUAS",10,0,10
"145","LAW119",2023,2023-08-05,"44","PACA6",3,0,3
"146","LAW119",2023,2023-08-05,"44","BAHY",2,0,2
"147","LAW119",2023,2023-08-05,"44","LACO13",1,0,1
"148","LAW119",2023,2023-08-05,"44","ELEOC",3,0,3
"149","LAW119",2023,2023-08-05,"44","IVAX",2,0,2
"150","LAW119",2023,2023-08-05,"44","CAREX",10,0,10
"151","LAW119",2023,2023-08-05,"44","TYLA",1,0,1
"152","LAW119",2023,2023-08-05,"64","ATTO",12,11,23
"153","LAW119",2023,2023-08-05,"64","MUAS",4,0,4
"154","LAW119",2023,2023-08-05,"64","SAVE4",0,1,1
"155","LAW119",2023,2023-08-05,"64","BAHY",11,0,11
"156","LAW119",2023,2023-08-05,"64","ERNA10",5,4,9
"157","LAW119",2023,2023-08-05,"64","SATR12",1,0,1
"158","LAW119",2023,2023-08-05,"64","IVAX",1,0,1
"159","LAW119",2023,2023-08-05,"64","DISP",1,0,1
"160","LAW119",2023,2023-08-05,"64","CAREX",1,0,1
"161","LAW119",2023,2023-08-05,"64","CYDA",1,0,1
"162","LAW119",2023,2023-08-05,"62","ATTO",1,1,2
"163","LAW119",2023,2023-08-05,"62","MUAS",8,0,8
"164","LAW119",2023,2023-08-05,"62","SAVE4",1,0,1
"165","LAW119",2023,2023-08-05,"62","PACA6",2,0,2
"166","LAW119",2023,2023-08-05,"62","LACO13",1,0,1
"167","LAW119",2023,2023-08-05,"62","ELEOC",26,0,26
"168","LAW119",2023,2023-08-05,"62","ERNA10",0,1,1
"169","LAW119",2023,2023-08-05,"62","IVAX",2,0,2
"170","LAW119",2023,2023-08-05,"62","FORB",1,0,1
"171","LAW119",2023,2023-08-05,"62","CAREX",1,0,1
"172","LAW119",2023,2023-08-05,"62","LETR5",12,0,12
"173","LAW119",2023,2023-08-05,"62","ASFA",2,0,2
"174","LAW119",2023,2023-08-05,"62","EPCI",2,0,2
"175","LAW119",2023,2023-08-05,"62","POMO5",1,0,1
"176","LAW119",2023,2023-08-05,"18","SAVE4",6,7,13
"177","LAW119",2023,2023-08-05,"18","ATTO",12,6,18
"178","LAW119",2023,2023-08-05,"29","SAVE4",0,1,1
"179","LAW119",2023,2023-08-05,"29","ATTO",4,1,5
"180","LAW119",2023,2023-08-05,"29","ERNA10",5,5,10
"181","LAW119",2023,2023-08-05,"29","SATR12",13,0,13
"182","LAW119",2023,2023-08-05,"29","IVAX",2,0,2
"183","LAW119",2023,2023-08-05,"28","ATTO",1,1,2
"184","LAW119",2023,2023-08-05,"28","SATR12",3,0,3
"185","LAW119",2023,2023-08-05,"28","ERIOG",2,0,2
"186","LAW119",2023,2023-08-05,"57","SAVE4",3,4,7
"187","LAW119",2023,2023-08-05,"57","ATTO",5,0,5
"188","LAW119",2023,2023-08-05,"57","ERNA10",1,0,1
"189","LAW119",2023,2023-08-05,"57","BAHY",4,0,4
"190","LAW119",2023,2023-08-05,"57","ATCO",0,1,1
"191","LAW119",2023,2023-08-05,"4","XAST",1,0,1
"192","LAW119",2023,2023-08-05,"4","ATTO",0,4,4
"193","LAW119",2023,2023-08-05,"4","ERNA10",5,6,11
"194","LAW119",2023,2023-08-05,"4","TYLA",1,0,1
"195","LAW119",2023,2023-08-05,"4","ECCR",1,0,1
"196","LAW119",2023,2023-08-05,"4","POMO5",1,0,1
"197","LAW119",2023,2023-08-05,"4","BAHY",1,0,1
"198","LAW119",2023,2023-08-05,"4","DISP",4,0,4
"199","LAW119",2023,2023-08-05,"4","LACO13",1,0,1
"200","LAW119",2023,2023-08-05,"4","MUAS",2,0,2
"201","LAW119",2023,2023-08-05,"4","COCA5",3,0,3
"202","LAW119",2023,2023-08-05,"50","EPCI",12,0,12
"203","LAW119",2023,2023-08-05,"50","ELEOC",11,0,11
"204","LAW119",2023,2023-08-05,"50","CAREX",6,1,7
"205","LAW119",2023,2023-08-05,"50","SAEX",14,2,16
"206","LAW119",2023,2023-08-05,"50","MUAS",18,0,18
"207","LAW119",2023,2023-08-05,"50","PACA6",8,0,8
"208","LAW119",2023,2023-08-05,"50","TARA",1,0,1
"209","LAW119",2023,2023-08-05,"50","COCA5",1,0,1
"210","LAW119",2023,2023-08-05,"50","JUARL",3,0,3
"211","LAW119",2023,2023-08-05,"50","SPAI",1,0,1
"212","LAW119",2023,2023-08-05,"50","TYLA",1,0,1
"213","LAW119",2023,2023-08-05,"50","POFR2",2,0,2
"214","LAW119",2023,2023-08-05,"50","DISP",5,0,5
"215","LAW119",2023,2023-08-05,"50","BAHY",2,0,2
"216","LAW119",2023,2023-08-05,"50","CYDA",2,0,2
"217","LAW119",2023,2023-08-05,"50","LELA2",1,0,1
"218","LAW119",2023,2023-08-05,"27","CAREX",1,0,1
"219","LAW119",2023,2023-08-05,"27","BAHY",38,0,38
"220","LAW119",2023,2023-08-05,"27","CYDA",2,0,2
"221","LAW119",2023,2023-08-05,"27","ERNA10",8,9,17
"222","LAW119",2023,2023-08-05,"27","IVAX",5,0,5
"223","LAW119",2023,2023-08-05,"27","LACO13",1,0,1
"224","LAW119",2023,2023-08-05,"27","SATR12",5,0,5
"225","LAW119",2023,2023-08-05,"27","HECU3",1,0,1
"226","LAW119",2023,2023-08-05,"19","ATTO",1,7,8
"227","LAW119",2023,2023-08-05,"19","ERNA10",9,1,10
"228","LAW119",2023,2023-08-05,"19","SATR12",12,0,12
"229","LAW119",2023,2023-08-05,"19","BAHY",2,0,2
"230","LAW119",2023,2023-08-04,"59","PACA6",6,0,6
"231","LAW119",2023,2023-08-04,"59","DISP",2,0,2
"232","LAW119",2023,2023-08-04,"59","CYDA",20,0,20
"233","LAW119",2023,2023-08-04,"59","HECU3",1,0,1
"234","LAW119",2023,2023-08-04,"59","LASE",1,0,1
"235","LAW119",2023,2023-08-04,"59","HEAN3",1,0,1
"236","LAW119",2023,2023-08-04,"59","LELA2",10,0,10
"237","LAW119",2023,2023-08-04,"59","MEOF",2,0,2
"238","LAW119",2023,2023-08-04,"59","BAHY",13,0,13
"239","LAW119",2023,2023-08-04,"59","LACO13",4,0,4
"240","LAW119",2023,2023-08-04,"59","IVAX",2,0,2
"241","LAW119",2023,2023-08-04,"59","MUAS",9,0,9
"242","LAW119",2023,2023-08-04,"59","SPAI",1,0,1
"243","LAW119",2023,2023-08-04,"46","PACA6",24,0,24
"244","LAW119",2023,2023-08-04,"46","DISP",1,0,1
"245","LAW119",2023,2023-08-04,"46","CYDA",2,0,2
"246","LAW119",2023,2023-08-04,"46","HECU3",2,0,2
"247","LAW119",2023,2023-08-04,"46","LELA2",3,0,3
"248","LAW119",2023,2023-08-04,"46","BAHY",1,0,1
"249","LAW119",2023,2023-08-04,"46","ATTO",4,0,4
"250","LAW119",2023,2023-08-04,"46","LACO13",2,0,2
"251","LAW119",2023,2023-08-04,"46","IVAX",7,0,7
"252","LAW119",2023,2023-08-04,"46","ELEOC",23,0,23
"253","LAW119",2023,2023-08-04,"46","MUAS",6,0,6
"254","LAW119",2023,2023-08-04,"60","PACA6",5,0,5
"255","LAW119",2023,2023-08-04,"60","CYDA",21,0,21
"256","LAW119",2023,2023-08-04,"60","HEAN3",6,0,6
"257","LAW119",2023,2023-08-04,"60","MEOF",1,0,1
"258","LAW119",2023,2023-08-04,"60","BAHY",24,0,24
"259","LAW119",2023,2023-08-04,"60","ATTO",1,0,1
"260","LAW119",2023,2023-08-04,"60","ERNA10",6,1,7
"261","LAW119",2023,2023-08-04,"60","IVAX",7,0,7
"262","LAW119",2023,2023-08-04,"3","PACA6",11,0,11
"263","LAW119",2023,2023-08-04,"3","CYDA",20,0,20
"264","LAW119",2023,2023-08-04,"3","HEAN3",3,0,3
"265","LAW119",2023,2023-08-04,"3","ERNA10",2,0,2
"266","LAW119",2023,2023-08-04,"3","IVAX",2,0,2
"267","LAW119",2023,2023-08-04,"3","ELEOC",27,0,27
"268","LAW119",2023,2023-08-04,"3","MUAS",1,0,1
"269","LAW119",2023,2023-08-04,"3","POMO5",6,0,6
"270","LAW119",2023,2023-08-04,"3","TARA",1,0,1
"271","LAW119",2023,2023-08-04,"3","CAREX",2,0,2
"272","LAW119",2023,2023-08-04,"3","SALA3",1,0,1
"273","LAW119",2023,2023-08-04,"52","PACA6",7,0,7
"274","LAW119",2023,2023-08-04,"52","DISP",37,0,37
"275","LAW119",2023,2023-08-04,"52","CYDA",2,0,2
"276","LAW119",2023,2023-08-04,"52","BAHY",6,0,6
"277","LAW119",2023,2023-08-04,"52","ATTO",5,15,20
"278","LAW119",2023,2023-08-04,"52","IVAX",2,0,2
"279","LAW119",2023,2023-08-04,"52","MUAS",3,0,3
"280","LAW119",2023,2023-08-04,"52","EPCI",2,0,2
"281","LAW119",2023,2023-08-04,"39","PACA6",12,0,12
"282","LAW119",2023,2023-08-04,"39","HEAN3",3,0,3
"283","LAW119",2023,2023-08-04,"39","LETR5",1,0,1
"284","LAW119",2023,2023-08-04,"39","ASFA",1,0,1
"285","LAW119",2023,2023-08-04,"39","TARA",4,1,5
"286","LAW119",2023,2023-08-04,"39","SPAI",3,0,3
"287","LAW119",2023,2023-08-04,"39","LELA2",26,0,26
"288","LAW119",2023,2023-08-04,"39","EPCI",3,0,3
"289","LAW119",2023,2023-08-04,"39","DISP",8,0,8
"290","LAW119",2023,2023-08-04,"39","BAHY",1,0,1
"291","LAW119",2023,2023-08-04,"39","ELEOC",7,0,7
"292","LAW119",2023,2023-08-04,"39","MUAS",9,0,9
"293","LAW119",2023,2023-08-04,"39","ATTO",2,1,3
"294","LAW119",2023,2023-08-04,"39","CYDA",6,0,6
"295","LAW119",2023,2023-08-04,"39","IVAX",1,0,1
"296","LAW119",2023,2023-08-04,"2","PACA6",35,0,35
"297","LAW119",2023,2023-08-04,"2","LELA2",4,0,4
"298","LAW119",2023,2023-08-04,"2","DISP",28,0,28
"299","LAW119",2023,2023-08-04,"2","BAHY",1,0,1
"300","LAW119",2023,2023-08-04,"2","ERNA10",1,2,3
"301","LAW119",2023,2023-08-04,"2","MUAS",5,0,5
"302","LAW119",2023,2023-08-04,"2","ATTO",1,4,5
"303","LAW119",2023,2023-08-04,"24","PACA6",15,0,15
"304","LAW119",2023,2023-08-04,"24","TARA",1,0,1
"305","LAW119",2023,2023-08-04,"24","SPAI",1,0,1
"306","LAW119",2023,2023-08-04,"24","LELA2",2,0,2
"307","LAW119",2023,2023-08-04,"24","DISP",10,0,10
"308","LAW119",2023,2023-08-04,"24","ELEOC",4,0,4
"309","LAW119",2023,2023-08-04,"24","MUAS",19,0,19
"310","LAW119",2023,2023-08-04,"24","SAEX",2,0,2
"311","LAW119",2023,2023-08-04,"24","ATTO",1,1,2
"312","LAW119",2023,2023-08-04,"24","TYLA",9,0,9
"313","LAW119",2023,2023-08-04,"24","CYDA",3,0,3
"314","LAW119",2023,2023-08-04,"24","FORB",6,0,6
"315","LAW119",2023,2023-08-04,"24","ATTO",0,4,4
"316","LAW119",2023,2023-08-04,"24","CYDA",1,0,1
"317","LAW119",2023,2023-08-04,"24","IVAX",2,0,2
"318","LAW119",2023,2023-08-04,"24","LACO13",1,0,1
"319","LAW119",2023,2023-08-04,"24","COCA5",1,0,1
"320","LAW119",2023,2023-08-04,"24","HOJU",1,0,1
"321","LAW119",2023,2023-08-04,"24","CHLE4",1,0,1
"322","LAW119",2023,2023-08-04,"23","ERNA10",5,5,10
"323","LAW119",2023,2023-08-04,"23","HAGL",2,0,2
"324","LAW119",2023,2023-08-04,"23","SATR12",4,0,4
"325","LAW119",2023,2023-08-04,"23","SPAI",1,0,1
"326","LAW119",2023,2023-08-04,"23","ATTO",1,0,1
"327","LAW119",2023,2023-08-04,"23","BAHY",1,0,1
"328","LAW119",2023,2023-08-04,"61","ERNA10",4,4,8
"329","LAW119",2023,2023-08-04,"61","SPAI",1,0,1
"330","LAW119",2023,2023-08-04,"61","ATTO",17,13,30
"331","LAW119",2023,2023-08-04,"54","ERNA10",4,3,7
"332","LAW119",2023,2023-08-04,"54","SATR12",2,1,3
"333","LAW119",2023,2023-08-04,"54","SPAI",4,0,4
"334","LAW119",2023,2023-08-04,"54","ATTO",9,6,15
"335","LAW119",2023,2023-08-04,"54","BAHY",2,0,2
"336","LAW119",2023,2023-08-04,"54","IVAX",5,0,5
"337","LAW119",2023,2023-08-04,"20","ERNA10",13,4,17
"338","LAW119",2023,2023-08-04,"20","ELEOC",2,0,2
"339","LAW119",2023,2023-08-04,"20","CEEX",1,0,1
"340","LAW119",2023,2023-08-04,"20","SPAI",40,0,40
"341","LAW119",2023,2023-08-04,"20","ATTO",2,1,3
"342","LAW119",2023,2023-08-04,"20","BAHY",3,0,3
"343","LAW119",2023,2023-08-04,"20","DISP",5,0,5
"344","LAW119",2023,2023-08-04,"20","HEAN3",9,1,10
"345","LAW119",2023,2023-08-04,"14","ERNA10",4,2,6
"346","LAW119",2023,2023-08-04,"14","LACO13",1,0,1
"347","LAW119",2023,2023-08-04,"14","SPAI",33,0,33
"348","LAW119",2023,2023-08-04,"14","ATTO",2,2,4
"349","LAW119",2023,2023-08-04,"14","DISP",0,1,1
"350","LAW119",2023,2023-08-04,"13","SPAI",41,0,41
"351","LAW119",2023,2023-08-04,"13","ATTO",3,4,7
"352","LAW119",2023,2023-08-04,"13","ERNA10",1,4,5
"353","LAW119",2023,2023-08-04,"13","BAHY",3,0,3
"354","LAW119",2023,2023-08-04,"13","DISP",1,0,1
"355","LAW119",2023,2023-08-04,"13","LACO13",1,0,1
"356","LAW119",2023,2023-08-04,"51","SPAI",9,0,9
"357","LAW119",2023,2023-08-04,"51","ERNA10",1,0,1
"358","LAW119",2023,2023-08-04,"51","DISP",6,0,6
"359","LAW119",2023,2023-08-04,"51","MUAS",4,0,4
"360","LAW119",2023,2023-08-04,"51","HEAN3",1,0,1
"361","LAW119",2023,2023-08-04,"51","PACA6",4,0,4
"362","LAW119",2023,2023-08-04,"51","LETR5",4,0,4
"363","LAW119",2023,2023-08-04,"51","ELEOC",13,0,13
"364","LAW119",2023,2023-08-04,"51","ASFA",4,0,4
"365","LAW119",2023,2023-08-04,"51","EPCI",5,0,5
"366","LAW119",2023,2023-08-04,"51","POMO5",3,0,3
"367","LAW119",2023,2023-08-04,"51","IVAX",2,0,2
"368","LAW119",2023,2023-08-04,"8","SPAI",8,0,8
"369","LAW119",2023,2023-08-04,"8","ATTO",6,3,9
"370","LAW119",2023,2023-08-04,"8","ERNA10",4,5,9
"371","LAW119",2023,2023-08-04,"41","ATTO",0,2,2
"372","LAW119",2023,2023-08-04,"41","ERNA10",10,6,16
"373","LAW119",2023,2023-08-04,"41","DISP",1,0,1
"374","LAW119",2023,2023-08-04,"7","ATTO",18,10,28
"375","LAW119",2023,2023-08-04,"7","DISP",2,0,2
"376","LAW119",2023,2023-08-05,"16","ATTO",7,3,10
"377","LAW119",2023,2023-08-05,"16","ERNA10",16,9,25
"378","LAW119",2023,2023-08-05,"36","ATTO",18,9,27
"379","LAW119",2023,2023-08-05,"36","ERNA10",8,7,15
"380","LAW119",2023,2023-08-05,"36","SATR12",1,0,1
"381","LAW119",2023,2023-08-05,"32","ERNA10",11,12,23
"382","LAW119",2023,2023-08-05,"32","SATR12",12,0,12
"383","LAW119",2023,2023-08-05,"32","SPAI",3,0,3
"384","LAW119",2023,2023-08-05,"32","DISP",1,5,6
"385","LAW119",2023,2023-08-05,"55","ATTO",2,0,2
"386","LAW119",2023,2023-08-05,"55","ERNA10",13,7,20
"387","LAW119",2023,2023-08-05,"55","SATR12",13,0,13
"388","LAW119",2023,2023-08-05,"55","DISP",6,0,6
"389","LAW119",2023,2023-08-05,"1","ATTO",3,2,5
"390","LAW119",2023,2023-08-05,"1","ERNA10",10,8,18
"391","LAW119",2023,2023-08-05,"1","SPAI",3,0,3
"392","LAW119",2023,2023-08-05,"1","DISP",5,2,7
"393","LAW119",2023,2023-08-05,"5","ERNA10",2,0,2
"394","LAW119",2023,2023-08-05,"5","SATR12",9,0,9
"395","LAW119",2023,2023-08-05,"5","STEPH",1,0,1
"396","LAW119",2023,2023-08-05,"58","ERNA10",9,4,13
"397","LAW119",2023,2023-08-05,"58","ATTO",14,3,17
"398","LAW119",2023,2023-08-05,"58","BAHY",1,0,1
"399","LAW119",2023,2023-08-05,"58","ERIOG",1,0,1
"400","LAW119",2023,2023-08-05,"47","ERNA10",21,8,29
"401","LAW119",2023,2023-08-05,"47","SATR12",5,0,5
"402","LAW119",2023,2023-08-05,"47","BAHY",2,0,2
"403","LAW119",2023,2023-08-05,"47","ERIOG",1,0,1
"404","LAW119",2023,2023-08-05,"47","LACO13",1,0,1
"405","LAW119",2023,2023-08-05,"47","DISP",1,0,1
"406","LAW119",2023,2023-08-05,"47","OENOT",1,0,1
"407","LAW119",2023,2023-08-05,"6","ERNA10",26,3,29
"408","LAW119",2023,2023-08-05,"6","LACO13",2,0,2
"409","LAW119",2023,2023-08-05,"6","CAREX",1,0,1
"410","LAW119",2023,2023-08-05,"26","ERNA10",13,9,22
"411","LAW119",2023,2023-08-05,"26","SATR12",2,0,2
"412","LAW119",2023,2023-08-05,"26","ERIOG",2,0,2
"413","LAW119",2023,2023-09-15,"35","ELEOC",26,0,26
"414","LAW119",2023,2023-09-15,"35","MUAS",17,0,17
"415","LAW119",2023,2023-09-15,"35","POFR2",6,0,6
"416","LAW119",2023,2023-09-15,"35","CYDA",3,0,3
"417","LAW119",2023,2023-09-15,"35","LETR5",4,0,4
"418","LAW119",2023,2023-09-15,"35","EUOC4",3,0,3
"419","LAW119",2023,2023-09-15,"35","LELA2",4,8,12
"420","LAW119",2023,2023-09-15,"35","BAHY",1,0,1
"421","LAW119",2023,2023-09-15,"48","ATTO",20,0,20
"422","LAW119",2023,2023-09-15,"48","EPCI",2,0,2
"423","LAW119",2023,2023-09-15,"48","ELEOC",5,0,5
"424","LAW119",2023,2023-09-15,"48","BAHY",5,0,5
"425","LAW119",2023,2023-09-15,"48","JUARL",1,0,1
"426","LAW119",2023,2023-09-15,"48","COCA5",2,0,2
"427","LAW119",2023,2023-09-15,"48","MUAS",2,0,2
"428","LAW119",2023,2023-09-15,"11","ELEOC",46,0,46
"429","LAW119",2023,2023-09-15,"11","ATTO",1,2,3
"430","LAW119",2023,2023-09-15,"11","POFR2",0,1,1
"431","LAW119",2023,2023-09-15,"11","ERNA10",0,0,0
"432","LAW119",2023,2023-09-15,"11","BAHY",14,0,14
"433","LAW119",2023,2023-09-15,"11","LELA2",1,3,4
"434","LAW119",2023,2023-09-15,"11","PACA6",1,0,1
"435","LAW119",2023,2023-09-15,"11","MUAS",1,0,1
"436","LAW119",2023,2023-09-15,"56","POFR2",14,0,14
"437","LAW119",2023,2023-09-15,"56","BAHY",5,0,5
"438","LAW119",2023,2023-09-15,"56","IVAX",7,0,7
"439","LAW119",2023,2023-09-15,"56","MUAS",22,0,22
"440","LAW119",2023,2023-09-15,"56","PSLU6",1,0,1
"441","LAW119",2023,2023-09-15,"56","PACA6",1,0,1
"442","LAW119",2023,2023-09-15,"56","COCA5",2,0,2
"443","LAW119",2023,2023-09-15,"56","MEOF",9,0,9
"444","LAW119",2023,2023-09-15,"56","EUOC4",5,0,5
"445","LAW119",2023,2023-09-15,"56","SAEX",3,0,3
"446","LAW119",2023,2023-09-15,"56","ELEOC",5,0,5
"447","LAW119",2023,2023-09-15,"56","ATTO",4,0,4
"448","LAW119",2023,2023-09-15,"56","EPCI",1,0,1
"449","LAW119",2023,2023-09-15,"56","DISP",1,0,1
"450","LAW119",2023,2023-09-15,"30","POFR2",24,0,24
"451","LAW119",2023,2023-09-15,"30","BAHY",11,0,11
"452","LAW119",2023,2023-09-15,"30","ATTO",5,0,5
"453","LAW119",2023,2023-09-15,"30","MUAS",4,0,4
"454","LAW119",2023,2023-09-15,"30","DISP",9,0,9
"455","LAW119",2023,2023-09-15,"30","ERNA10",5,0,5
"456","LAW119",2023,2023-09-15,"30","IVAX",1,0,1
"457","LAW119",2023,2023-09-15,"30","LELA2",1,0,1
"458","LAW119",2023,2023-09-15,"37","ERNA10",25,0,25
"459","LAW119",2023,2023-09-15,"37","POFR2",3,0,3
"460","LAW119",2023,2023-09-15,"37","MUAS",11,0,11
"461","LAW119",2023,2023-09-15,"37","ATTO",10,0,10
"462","LAW119",2023,2023-09-15,"37","LETR5",2,0,2
"463","LAW119",2023,2023-09-15,"37","PSLU6",2,0,2
"464","LAW119",2023,2023-09-15,"37","MEOF",6,0,6
"465","LAW119",2023,2023-09-15,"37","HEAN3",1,0,1
"466","LAW119",2023,2023-09-15,"37","DISP",4,0,4
"467","LAW119",2023,2023-09-15,"37","LACO13",3,0,3
"468","LAW119",2023,2023-09-15,"37","BAHY",6,0,6
"469","LAW119",2023,2023-09-15,"31","ERNA10",5,0,5
"470","LAW119",2023,2023-09-15,"31","POFR2",23,0,23
"471","LAW119",2023,2023-09-15,"31","MUAS",2,6,8
"472","LAW119",2023,2023-09-15,"31","MEOF",45,0,45
"473","LAW119",2023,2023-09-15,"43","ERNA10",6,0,6
"474","LAW119",2023,2023-09-15,"43","POFR2",5,0,5
"475","LAW119",2023,2023-09-15,"43","MUAS",7,0,7
"476","LAW119",2023,2023-09-15,"43","PSLU6",2,0,2
"477","LAW119",2023,2023-09-15,"43","MEOF",1,0,1
"478","LAW119",2023,2023-09-15,"43","PACA6",1,0,1
"479","LAW119",2023,2023-09-15,"43","EPCI",4,0,4
"480","LAW119",2023,2023-09-15,"43","TYLA",15,0,15
"481","LAW119",2023,2023-09-15,"43","BOMA7",5,0,5
"482","LAW119",2023,2023-09-15,"43","LACO13",2,0,2
"483","LAW119",2023,2023-09-15,"43","BAHY",9,0,9
"484","LAW119",2023,2023-09-15,"43","IVAX",3,0,3
"485","LAW119",2023,2023-09-15,"43","JUARL",1,0,1
"486","LAW119",2023,2023-09-15,"42","BAHY",34,0,34
"487","LAW119",2023,2023-09-15,"42","ERNA10",20,0,20
"488","LAW119",2023,2023-09-15,"42","EPCI",1,0,1
"489","LAW119",2023,2023-09-15,"42","IVAX",2,0,2
"490","LAW119",2023,2023-09-15,"40","BAHY",8,0,8
"491","LAW119",2023,2023-09-15,"40","ERNA10",10,0,10
"492","LAW119",2023,2023-09-15,"40","ATTO",9,0,9
"493","LAW119",2023,2023-09-15,"40","DISP",12,0,12
"494","LAW119",2023,2023-09-15,"25","ERNA10",0,0,0
"495","LAW119",2023,2023-09-15,"25","ELEOC",57,0,57
"496","LAW119",2023,2023-09-15,"25","MUAS",1,2,3
"497","LAW119",2023,2023-09-15,"25","JUTO",1,0,1
"498","LAW119",2023,2023-09-15,"25","TYLA",4,0,4
"499","LAW119",2023,2023-09-15,"25","LELA2",0,3,3
"500","LAW119",2023,2023-09-15,"25","LACO13",1,0,1
"501","LAW119",2023,2023-09-15,"25","EPCI",1,0,1
"502","LAW119",2023,2023-09-15,"63","SAVE4",6,1,7
"503","LAW119",2023,2023-09-15,"63","ERNA10",2,1,3
"504","LAW119",2023,2023-09-15,"63","DISP",1,0,1
"505","LAW119",2023,2023-09-15,"63","BAHY",9,0,9
"506","LAW119",2023,2023-09-15,"63","ATTO",1,0,1
"507","LAW119",2023,2023-09-15,"63","EPCI",1,0,1
"508","LAW119",2023,2023-09-15,"63","ELEOC",6,0,6
"509","LAW119",2023,2023-09-15,"63","JUARL",2,0,2
"510","LAW119",2023,2023-09-15,"63","LELA2",1,0,1
"511","LAW119",2023,2023-09-15,"63","LACO13",1,0,1
"512","LAW119",2023,2023-09-15,"63","MUAS",1,0,1
"513","LAW119",2023,2023-09-15,"33","POFR2",16,0,16
"514","LAW119",2023,2023-09-15,"33","TYLA",5,0,5
"515","LAW119",2023,2023-09-15,"33","SAEX",3,0,3
"516","LAW119",2023,2023-09-15,"33","EPCI",17,3,20
"517","LAW119",2023,2023-09-15,"33","MUAS",9,0,9
"518","LAW119",2023,2023-09-15,"33","POMO5",1,0,1
"519","LAW119",2023,2023-09-15,"33","BAHY",8,0,8
"520","LAW119",2023,2023-09-15,"33","ERNA10",2,0,2
"521","LAW119",2023,2023-09-15,"33","DISP",5,0,5
"522","LAW119",2023,2023-09-15,"33","LELA2",7,2,9
"523","LAW119",2023,2023-09-15,"33","EUOC4",3,0,3
"524","LAW119",2023,2023-09-15,"33","MEOF",3,0,3
"525","LAW119",2023,2023-09-15,"49","POFR2",4,0,4
"526","LAW119",2023,2023-09-15,"49","TYLA",16,0,16
"527","LAW119",2023,2023-09-15,"49","SAEX",1,1,2
"528","LAW119",2023,2023-09-15,"49","EPCI",4,1,5
"529","LAW119",2023,2023-09-15,"49","MUAS",23,0,23
"530","LAW119",2023,2023-09-15,"49","POMO5",1,3,4
"531","LAW119",2023,2023-09-15,"49","BAHY",1,0,1
"532","LAW119",2023,2023-09-15,"49","TARA",2,0,2
"533","LAW119",2023,2023-09-15,"49","ATTO",1,0,1
"534","LAW119",2023,2023-09-15,"49","LELA2",1,1,2
"535","LAW119",2023,2023-09-15,"49","JUARL",2,0,2
"536","LAW119",2023,2023-09-15,"49","DISP",4,0,4
"537","LAW119",2023,2023-09-15,"49","CAREX",16,0,16
"538","LAW119",2023,2023-09-15,"9","MUAS",31,0,31
"539","LAW119",2023,2023-09-15,"9","BAHY",28,0,28
"540","LAW119",2023,2023-09-15,"9","LELA2",5,4,9
"541","LAW119",2023,2023-09-15,"9","TYLA",3,0,3
"542","LAW119",2023,2023-09-15,"9","CAREX",1,0,1
"543","LAW119",2023,2023-09-15,"9","ATTO",1,1,2
"544","LAW119",2023,2023-09-15,"9","SAVE4",2,0,2
"545","LAW119",2023,2023-09-15,"9","LACO13",1,0,1
"546","LAW119",2023,2023-09-15,"15","MUAS",15,5,20
"547","LAW119",2023,2023-09-15,"15","BAHY",18,0,18
"548","LAW119",2023,2023-09-15,"15","LELA2",11,0,11
"549","LAW119",2023,2023-09-15,"15","TYLA",1,0,1
"550","LAW119",2023,2023-09-15,"15","CAREX",4,0,4
"551","LAW119",2023,2023-09-15,"15","ATTO",0,1,1
"552","LAW119",2023,2023-09-15,"15","SAEX",3,0,3
"553","LAW119",2023,2023-09-15,"15","JUTO",4,0,4
"554","LAW119",2023,2023-09-15,"15","POFR2",9,0,9
"555","LAW119",2023,2023-09-15,"15","EPCI",3,0,3
"556","LAW119",2023,2023-09-15,"15","SALA6",1,0,1
"557","LAW119",2023,2023-09-15,"15","PACA6",2,0,2
"558","LAW119",2023,2023-09-15,"45","MUAS",2,0,2
"559","LAW119",2023,2023-09-15,"45","BAHY",31,0,31
"560","LAW119",2023,2023-09-15,"45","ATTO",9,0,9
"561","LAW119",2023,2023-09-15,"45","SAVE4",7,0,7
"562","LAW119",2023,2023-09-15,"34","BAHY",30,0,30
"563","LAW119",2023,2023-09-15,"34","LELA2",12,0,12
"564","LAW119",2023,2023-09-15,"34","ATTO",9,0,9
"565","LAW119",2023,2023-09-15,"34","SPAI",2,0,2
"566","LAW119",2023,2023-09-15,"34","ERNA10",3,0,3
"567","LAW029",2023,2023-07-26,"35","SATR12",31,0,31
"568","LAW029",2023,2023-07-26,"35","ATTO",3,4,7
"569","LAW029",2023,2023-07-26,"35","ERNA10",0,1,1
"570","LAW029",2023,2023-07-26,"19","SATR12",16,2,18
"571","LAW029",2023,2023-07-26,"19","ATTO",0,1,1
"572","LAW029",2023,2023-07-26,"12","SATR12",1,0,1
"573","LAW029",2023,2023-07-26,"12","ATTO",6,11,17
"574","LAW029",2023,2023-07-26,"12","HAGL",1,0,1
"575","LAW029",2023,2023-07-26,"8","SATR12",7,3,10
"576","LAW029",2023,2023-07-26,"8","ATTO",4,2,6
"577","LAW029",2023,2023-07-26,"27","SATR12",16,7,23
"578","LAW029",2023,2023-07-26,"27","ATTO",0,1,1
"579","LAW029",2023,2023-07-26,"37","IVAX",4,0,4
"580","LAW029",2023,2023-07-26,"37","BAHY",17,0,17
"581","LAW029",2023,2023-07-26,"21","SATR12",13,4,17
"582","LAW029",2023,2023-07-26,"21","ATTO",4,4,8
"583","LAW029",2023,2023-07-26,"15","JUARL",24,0,24
"584","LAW029",2023,2023-07-26,"15","MUAS",2,0,2
"585","LAW029",2023,2023-07-26,"15","TYLA",2,0,2
"586","LAW029",2023,2023-07-26,"15","MEOF",43,0,43
"587","LAW029",2023,2023-07-26,"15","CAREX",2,0,2
"588","LAW029",2023,2023-07-26,"15","DISP",1,0,1
"589","LAW029",2023,2023-07-26,"15","ASFA",2,0,2
"590","LAW029",2023,2023-07-26,"15","LETR5",3,0,3
"591","LAW029",2023,2023-07-26,"15","ERNA10",0,2,2
"592","LAW029",2023,2023-07-26,"15","COCA5",2,0,2
"593","LAW029",2023,2023-07-26,"15","LOTUS",1,0,1
"594","LAW029",2023,2023-07-26,"15","LELA2",1,0,1
"595","LAW029",2023,2023-07-26,"37","SATR12",11,0,11
"596","LAW029",2023,2023-07-26,"37","ATTO",0,1,1
"597","LAW029",2023,2023-07-26,"37","DISP",2,1,3
"598","LAW029",2023,2023-07-26,"37","LETR5",1,0,1
"599","LAW029",2023,2023-07-26,"37","ERNA10",16,7,23
"600","LAW029",2023,2023-07-26,"37","LELA2",4,0,4
"601","LAW029",2023,2023-07-26,"34","ATTO",6,9,15
"602","LAW029",2023,2023-07-26,"34","ERNA10",5,4,9
"603","LAW029",2023,2023-07-26,"11","SATR12",1,0,1
"604","LAW029",2023,2023-07-26,"11","ATTO",18,10,28
"605","LAW029",2023,2023-07-26,"11","ERNA10",5,1,6
"606","LAW029",2023,2023-07-26,"11","BAHY",4,0,4
"607","LAW029",2023,2023-07-26,"17","ATCO",6,8,14
"608","LAW029",2023,2023-07-26,"22","ATCO",13,8,21
"609","LAW029",2023,2023-07-26,"22","SAVE4",1,0,1
"610","LAW029",2023,2023-07-26,"6","ATCO",1,4,5
"611","LAW029",2023,2023-07-26,"6","SAVE4",3,3,6
"612","LAW029",2023,2023-07-26,"6","SATR12",19,1,20
"613","LAW029",2023,2023-07-26,"31","ATCO",3,1,4
"614","LAW029",2023,2023-07-26,"31","SAVE4",10,4,14
"615","LAW029",2023,2023-07-26,"31","SATR12",9,1,10
"616","LAW029",2023,2023-07-26,"40","ATCO",5,3,8
"617","LAW029",2023,2023-07-26,"40","SAVE4",4,1,5
"618","LAW029",2023,2023-07-26,"23","SAVE4",7,0,7
"619","LAW029",2023,2023-07-26,"23","SUMO",1,0,1
"620","LAW029",2023,2023-07-26,"23","ATTO",2,6,8
"621","LAW029",2023,2023-07-26,"23","ERNA10",9,3,12
"622","LAW029",2023,2023-07-26,"26","ERNA10",27,19,46
"623","LAW029",2023,2023-07-26,"30","SAVE4",2,0,2
"624","LAW029",2023,2023-07-26,"30","ATTO",16,4,20
"625","LAW029",2023,2023-07-26,"30","ERNA10",4,2,6
"626","LAW029",2023,2023-07-26,"30","SUMO",0,1,1
"627","LAW029",2023,2023-07-26,"30","ATCO",0,1,1
"628","LAW029",2023,2023-07-26,"1","SAVE4",1,0,1
"629","LAW029",2023,2023-07-26,"1","ATTO",2,3,5
"630","LAW029",2023,2023-07-26,"1","DISP",17,5,22
"631","LAW029",2023,2023-07-26,"4","ATTO",2,1,3
"632","LAW029",2023,2023-07-26,"4","ERNA10",1,0,1
"633","LAW029",2023,2023-07-26,"4","DISP",14,3,17
"634","LAW029",2023,2023-07-26,"33","ATTO",3,2,5
"635","LAW029",2023,2023-07-26,"33","DISP",11,0,11
"636","LAW029",2023,2023-07-26,"33","ALOC2",2,0,2
"637","LAW029",2023,2023-07-26,"33","ERNA10",1,0,1
"638","LAW029",2023,2023-07-26,"24","ERNA10",4,1,5
"639","LAW029",2023,2023-07-26,"24","ATCO",1,2,3
"640","LAW029",2023,2023-07-26,"24","SAVE4",4,1,5
"641","LAW029",2023,2023-07-26,"24","SATR12",1,1,2
"642","LAW029",2023,2023-07-26,"24","ATCA2",1,0,1
"643","LAW029",2023,2023-07-26,"16","ERNA10",1,0,1
"644","LAW029",2023,2023-07-26,"16","SAVE4",1,0,1
"645","LAW029",2023,2023-07-26,"16","SATR12",2,2,4
"646","LAW029",2023,2023-07-26,"28","ATTO",3,1,4
"647","LAW029",2023,2023-07-26,"28","ATCO",1,0,1
"648","LAW029",2023,2023-07-26,"28","SAVE4",13,2,15
"649","LAW029",2023,2023-07-26,"28","SATR12",2,4,6
"650","LAW029",2023,2023-07-26,"28","SUMO",0,1,1
"651","LAW029",2023,2023-07-26,"2","ATTO",7,4,11
"652","LAW029",2023,2023-07-26,"2","ATCO",1,1,2
"653","LAW029",2023,2023-07-26,"2","SAVE4",3,2,5
"654","LAW029",2023,2023-07-26,"2","SATR12",9,1,10
"655","LAW029",2023,2023-07-26,"2","SUMO",1,1,2
"656","LAW029",2023,2023-07-26,"9","ATTO",8,4,12
"657","LAW029",2023,2023-07-26,"9","SAVE4",8,2,10
"658","LAW029",2023,2023-07-26,"9","ERNA10",4,1,5
"659","LAW029",2023,2023-07-26,"9","SATR12",4,0,4
"660","LAW029",2023,2023-07-26,"7","ATTO",13,6,19
"661","LAW029",2023,2023-07-26,"7","SAVE4",6,4,10
"662","LAW029",2023,2023-07-26,"7","ERNA10",0,2,2
"663","LAW029",2023,2023-07-26,"29","ATTO",4,7,11
"664","LAW029",2023,2023-07-26,"29","SAVE4",10,6,16
"665","LAW029",2023,2023-07-26,"29","ERNA10",4,1,5
"666","LAW029",2023,2023-07-26,"10","ATTO",7,3,10
"667","LAW029",2023,2023-07-26,"10","SAVE4",1,2,3
"668","LAW029",2023,2023-07-26,"10","ERNA10",3,1,4
"669","LAW029",2023,2023-07-26,"10","SATR12",8,0,8
"670","LAW029",2023,2023-07-26,"3","ATTO",5,3,8
"671","LAW029",2023,2023-07-26,"3","SATR12",4,2,6
"672","LAW029",2023,2023-07-26,"14","ERNA10",2,5,7
"673","LAW029",2023,2023-07-26,"14","DISP",5,0,5
"674","LAW029",2023,2023-07-26,"14","ATTO",9,4,13
"675","LAW029",2023,2023-07-26,"13","ATTO",2,2,4
"676","LAW029",2023,2023-07-26,"13","SAVE4",7,1,8
"677","LAW029",2023,2023-07-26,"13","ATCO",5,1,6
"678","LAW029",2023,2023-07-26,"5","ATTO",3,0,3
"679","LAW029",2023,2023-07-26,"5","SAVE4",11,2,13
"680","LAW029",2023,2023-07-26,"5","ATCO",2,4,6
"681","LAW029",2023,2023-07-26,"32","SAVE4",5,1,6
"682","LAW029",2023,2023-07-26,"32","ATCO",10,1,11
"683","LAW029",2023,2023-07-26,"36","SAVE4",3,1,4
"684","LAW029",2023,2023-07-26,"36","ATCO",10,2,12
"685","LAW029",2023,2023-07-26,"36","ERNA10",1,0,1
"686","LAW029",2023,2023-07-26,"25","ATCO",3,2,5
"687","LAW029",2023,2023-07-26,"25","SAVE4",0,2,2
"688","LAW029",2023,2023-07-26,"18","ATCO",12,1,13
"689","LAW029",2023,2023-07-26,"18","PSARM",0,1,1
"690","LAW029",2023,2023-07-26,"18","ATPO",1,0,1
"691","LAW029",2023,2023-07-26,"20","DISP",16,1,17
"692","LAW029",2023,2023-07-26,"20","ATTO",2,2,4
"693","LAW029",2023,2023-07-26,"20","ERNA10",0,2,2
"694","LAW029",2023,2023-07-26,"39","SAVE4",4,0,4
"695","LAW029",2023,2023-07-26,"39","ATTO",7,3,10
"696","LAW029",2023,2023-07-26,"39","BAHY",1,0,1
"697","LAW029",2023,2023-07-26,"38","SAVE4",4,9,13
"698","LAW029",2023,2023-07-26,"38","ATTO",5,3,8
"699","LAW069",2023,2023-07-26,"2","ERNA10",7,13,20
"700","LAW069",2023,2023-07-26,"2","ATPH",4,0,4
"701","LAW069",2023,2023-07-26,"2","DISP",1,0,1
"702","LAW069",2023,2023-07-26,"2","HECU3",1,0,1
"703","LAW069",2023,2023-07-26,"2","SAVE4",1,6,7
"704","LAW069",2023,2023-07-26,"2","BAHY",14,0,14
"705","LAW069",2023,2023-07-26,"2","AMAC2",4,0,4
"706","LAW069",2023,2023-07-26,"3","ERNA10",12,6,18
"707","LAW069",2023,2023-07-26,"3","PSPO",3,5,8
"708","LAW069",2023,2023-07-26,"3","ATCA2",3,1,4
"709","LAW069",2023,2023-07-26,"11","ERNA10",4,3,7
"710","LAW069",2023,2023-07-26,"11","AMAC2",1,0,1
"711","LAW069",2023,2023-07-26,"11","ATCA2",5,1,6
"712","LAW069",2023,2023-07-26,"11","STEPH",5,0,5
"713","LAW069",2023,2023-07-26,"11","PSPO",0,2,2
"714","LAW069",2023,2023-07-26,"5","ERNA10",7,3,10
"715","LAW069",2023,2023-07-26,"5","AMAC2",5,0,5
"716","LAW069",2023,2023-07-26,"5","ATCA2",2,0,2
"717","LAW069",2023,2023-07-26,"5","SATR12",1,0,1
"718","LAW069",2023,2023-07-26,"8","ERNA10",2,1,3
"719","LAW069",2023,2023-07-26,"8","IVAX",9,0,9
"720","LAW069",2023,2023-07-26,"8","DISP",24,0,24
"721","LAW069",2023,2023-07-26,"8","HECU3",2,0,2
"722","LAW069",2023,2023-07-26,"8","ELEOC",2,0,2
"723","LAW069",2023,2023-07-26,"8","BAHY",15,0,15
"724","LAW069",2023,2023-07-26,"8","AMAC2",1,0,1
"725","LAW069",2023,2023-07-26,"8","SALA3",1,0,1
"726","LAW069",2023,2023-07-26,"8","ATSE2",1,0,1
"727","LAW069",2023,2023-07-26,"8","SPAI",3,0,3
"728","LAW069",2023,2023-07-26,"8","LELA2",2,0,2
"729","LAW069",2023,2023-07-26,"8","FORB",1,0,1
"730","LAW069",2023,2023-07-26,"8","HEAN3",2,0,2
"731","LAW069",2023,2023-07-26,"8","MUAS",1,0,1
"732","LAW069",2023,2023-07-26,"7","ATPH",2,0,2
"733","LAW069",2023,2023-07-26,"7","ATCA2",8,0,8
"734","LAW069",2023,2023-07-26,"7","DISP",10,0,10
"735","LAW069",2023,2023-07-26,"7","ERNA10",0,1,1
"736","LAW069",2023,2023-07-26,"7","AMAC2",1,0,1
"737","LAW069",2023,2023-07-26,"7","BAHY",3,0,3
"738","LAW069",2023,2023-07-26,"9","ERNA10",1,4,5
"739","LAW069",2023,2023-07-26,"9","AMAC2",15,0,15
"740","LAW069",2023,2023-07-26,"9","BAHY",7,0,7
"741","LAW069",2023,2023-07-26,"9","SATR12",12,1,13
"742","LAW069",2023,2023-07-26,"4","ATPH",1,0,1
"743","LAW069",2023,2023-07-26,"4","ERNA10",2,3,5
"744","LAW069",2023,2023-07-26,"4","AMAC2",12,0,12
"745","LAW069",2023,2023-07-26,"4","BAHY",30,0,30
"746","LAW069",2023,2023-07-26,"4","SATR12",8,0,8
"747","LAW069",2023,2023-07-26,"4","CHIN2",1,0,1
"748","LAW069",2023,2023-07-26,"6","DISP",1,0,1
"749","LAW069",2023,2023-07-26,"6","ERNA10",4,1,5
"750","LAW069",2023,2023-07-26,"6","AMAC2",15,0,15
"751","LAW069",2023,2023-07-26,"6","BAHY",13,0,13
"752","LAW069",2023,2023-07-26,"6","SATR12",3,0,3
"753","LAW069",2023,2023-07-26,"6","HECU3",9,0,9
"754","LAW069",2023,2023-07-26,"6","TARA",2,0,2
"755","LAW069",2023,2023-07-26,"6","FORB",2,0,2
"756","LAW069",2023,2023-07-26,"10","AMAC2",13,0,13
"757","LAW069",2023,2023-07-26,"10","SATR12",11,2,13
"758","LAW069",2023,2023-07-26,"1","JUARL",2,0,2
"759","LAW069",2023,2023-07-26,"1","DISP",2,0,2
"760","LAW069",2023,2023-07-26,"1","AMAC2",7,0,7
"761","LAW069",2023,2023-07-26,"1","ATCA2",4,2,6
"762","LAW069",2023,2023-07-26,"1","BAHY",7,1,8
"763","LAW069",2023,2023-07-26,"1","ERNA10",4,3,7
"764","LAW069",2023,2023-07-26,"1","CAREX",1,0,1
"765","LAW069",2023,2023-07-26,"1","HECU3",4,0,4
"766","LAW069",2023,2023-07-26,"1","SATR12",7,0,7
"767","LAW069",2023,2023-07-26,"12","AMAC2",10,0,10
"768","LAW069",2023,2023-07-26,"12","ATCA2",3,0,3
"769","LAW069",2023,2023-07-26,"12","BAHY",9,0,9
"770","LAW069",2023,2023-07-26,"12","ERNA10",3,8,11
"771","LAW069",2023,2023-07-26,"12","SATR12",2,0,2
"772","LAW069",2023,2023-07-26,"12","CHIN2",1,0,1
"773","LAW069",2023,2023-07-26,"12","CAREX",1,0,1
"774","LAW039",2023,2023-07-24,"6","SAVE4",7,1,8
"775","LAW039",2023,2023-07-24,"6","SATR12",7,0,7
"776","LAW039",2023,2023-07-24,"6","ATCO",1,1,2
"777","LAW039",2023,2023-07-24,"6","ERIOG",4,0,4
"778","LAW039",2023,2023-07-24,"8","SAVE4",8,1,9
"779","LAW039",2023,2023-07-24,"8","SATR12",2,0,2
"780","LAW039",2023,2023-07-24,"8","ATCO",10,2,12
"781","LAW039",2023,2023-07-24,"8","ERIOG",1,0,1
"782","LAW039",2023,2023-07-24,"8","PSARM",1,0,1
"783","LAW039",2023,2023-07-24,"12","SAVE4",4,1,5
"784","LAW039",2023,2023-07-24,"12","SATR12",4,0,4
"785","LAW039",2023,2023-07-24,"12","ATCO",2,1,3
"786","LAW039",2023,2023-07-24,"12","ERIOG",2,0,2
"787","LAW039",2023,2023-07-24,"11","SATR12",8,0,8
"788","LAW039",2023,2023-07-24,"11","ATCO",12,2,14
"789","LAW039",2023,2023-07-24,"11","ERIOG",1,0,1
"790","LAW039",2023,2023-07-24,"11","PSPO",0,1,1
"791","LAW039",2023,2023-07-24,"5","SAVE4",5,1,6
"792","LAW039",2023,2023-07-24,"5","SATR12",3,1,4
"793","LAW039",2023,2023-07-24,"5","ATCO",0,2,2
"794","LAW039",2023,2023-07-24,"5","PSARM",2,2,4
"795","LAW039",2023,2023-07-24,"2","SAVE4",3,8,11
"796","LAW039",2023,2023-07-24,"2","PSARM",3,1,4
"797","LAW039",2023,2023-07-24,"2","ATCO",0,1,1
"798","LAW039",2023,2023-07-24,"10","SAVE4",5,1,6
"799","LAW039",2023,2023-07-24,"10","PSARM",2,3,5
"800","LAW039",2023,2023-07-24,"1","SAVE4",8,3,11
"801","LAW039",2023,2023-07-24,"1","PSARM",1,1,2
"802","LAW039",2023,2023-07-24,"1","ATCO",3,1,4
"803","LAW039",2023,2023-07-24,"7","PSARM",0,2,2
"804","LAW039",2023,2023-07-24,"7","ATCO",2,1,3
"805","LAW039",2023,2023-07-24,"7","ERIOG",5,0,5
"806","LAW039",2023,2023-07-24,"7","SATR12",8,0,8
"807","LAW039",2023,2023-07-24,"9","ATCO",6,5,11
"808","LAW039",2023,2023-07-24,"9","ERIOG",1,0,1
"809","LAW039",2023,2023-07-24,"9","SATR12",1,0,1
"810","LAW039",2023,2023-07-24,"3","SATR12",1,0,1
"811","LAW039",2023,2023-07-24,"3","PSARM",2,4,6
"812","LAW039",2023,2023-07-24,"3","SAVE4",4,3,7
"813","LAW039",2023,2023-07-24,"3","ATCO",6,1,7
"814","LAW039",2023,2023-07-24,"4","SATR12",4,1,5
"815","LAW039",2023,2023-07-24,"4","PSARM",2,2,4
"816","LAW039",2023,2023-07-24,"4","SAVE4",3,2,5
"817","LAW039",2023,2023-07-24,"4","ATCO",1,0,1
"818","LAW104",2023,2023-07-27,"1","CHBE4",1,0,1
"819","LAW104",2023,2023-07-27,"1","BAHY",5,0,5
"820","LAW104",2023,2023-07-27,"1","SAVE4",10,4,14
"821","LAW104",2023,2023-07-27,"1","ERIOG",3,0,3
"822","LAW104",2023,2023-07-27,"1","ATTO",0,2,2
"823","LAW104",2023,2023-07-27,"8","SAVE4",8,2,10
"824","LAW104",2023,2023-07-27,"8","ATTO",0,3,3
"825","LAW104",2023,2023-07-27,"8","SATR12",2,1,3
"826","LAW104",2023,2023-07-27,"2","BAHY",4,0,4
"827","LAW104",2023,2023-07-27,"2","ATTO",4,14,18
"828","LAW104",2023,2023-07-27,"2","SATR12",1,0,1
"829","LAW104",2023,2023-07-27,"2","SPAI",3,0,3
"830","LAW104",2023,2023-07-27,"7","SAVE4",13,1,14
"831","LAW104",2023,2023-07-27,"7","ATTO",1,2,3
"832","LAW104",2023,2023-07-27,"7","ATCO",1,0,1
"833","LAW104",2023,2023-07-27,"11","BAHY",1,0,1
"834","LAW104",2023,2023-07-27,"11","ATTO",0,5,5
"835","LAW104",2023,2023-07-27,"11","SATR12",9,2,11
"836","LAW104",2023,2023-07-27,"11","HAGL",6,0,6
"837","LAW104",2023,2023-07-27,"11","ATSE2",0,1,1
"838","LAW104",2023,2023-07-27,"6","SATR12",17,3,20
"839","LAW104",2023,2023-07-27,"6","HAGL",1,0,1
"840","LAW104",2023,2023-07-27,"6","SAVE4",1,0,1
"841","LAW104",2023,2023-07-27,"6","ATTO",3,3,6
"842","LAW104",2023,2023-07-27,"6","BAHY",1,0,1
"843","LAW104",2023,2023-07-27,"12","SATR12",4,1,5
"844","LAW104",2023,2023-07-27,"12","SAVE4",4,3,7
"845","LAW104",2023,2023-07-27,"12","ATTO",0,2,2
"846","LAW104",2023,2023-07-27,"12","ERIOG",1,0,1
"847","LAW104",2023,2023-07-27,"10","SATR12",29,0,29
"848","LAW104",2023,2023-07-27,"10","ATTO",0,5,5
"849","LAW104",2023,2023-07-27,"10","BAHY",18,1,19
"850","LAW104",2023,2023-07-27,"5","SATR12",8,9,17
"851","LAW104",2023,2023-07-27,"5","HAGL",2,0,2
"852","LAW104",2023,2023-07-27,"5","ATTO",2,0,2
"853","LAW104",2023,2023-07-27,"5","CHBE4",1,0,1
"854","LAW104",2023,2023-07-27,"4","SATR12",3,3,6
"855","LAW104",2023,2023-07-27,"4","ATTO",0,8,8
"856","LAW104",2023,2023-07-27,"4","BAHY",30,3,33
"857","LAW104",2023,2023-07-27,"3","SAVE4",7,2,9
"858","LAW104",2023,2023-07-27,"3","SATR12",17,0,17
"859","LAW104",2023,2023-07-27,"3","HAGL",4,0,4
"860","LAW104",2023,2023-07-27,"3","ATTO",0,1,1
"861","LAW104",2023,2023-07-27,"3","BAHY",6,0,6
"862","LAW104",2023,2023-07-27,"9","SATR12",3,0,3
"863","LAW104",2023,2023-07-27,"9","HAGL",13,0,13
"864","LAW104",2023,2023-07-27,"9","ATTO",4,0,4
"865","LAW104",2023,2023-07-27,"9","BAHY",2,0,2
"866","PLC202",2023,2023-08-04,"11","PSARM",1,2,3
"867","PLC202",2023,2023-08-04,"11","EPNE",4,6,10
"868","PLC202",2023,2023-08-04,"11","ATCO",1,0,1
"869","PLC202",2023,2023-08-04,"11","ERIOG",1,0,1
"870","PLC202",2023,2023-08-04,"11","KRLA2",1,0,1
"871","PLC202",2023,2023-08-04,"11","CALI4",0,1,1
"872","PLC202",2023,2023-08-04,"11","TEAX",0,1,1
"873","PLC202",2023,2023-08-04,"3","PSARM",1,3,4
"874","PLC202",2023,2023-08-04,"3","EPNE",0,4,4
"875","PLC202",2023,2023-08-04,"3","ERNA10",3,3,6
"876","PLC202",2023,2023-08-04,"3","TEGL",0,3,3
"877","PLC202",2023,2023-08-04,"3","LYCIU",0,1,1
"878","PLC202",2023,2023-08-04,"1","PSARM",4,3,7
"879","PLC202",2023,2023-08-04,"1","EPNE",0,1,1
"880","PLC202",2023,2023-08-04,"1","ATCO",3,1,4
"881","PLC202",2023,2023-08-04,"1","SATR12",2,0,2
"882","PLC202",2023,2023-08-04,"1","ERNA10",5,1,6
"883","PLC202",2023,2023-08-04,"1","ARSP",0,1,1
"884","PLC202",2023,2023-08-04,"1","TEGL",0,1,1
"885","PLC202",2023,2023-08-04,"6","EPNE",2,1,3
"886","PLC202",2023,2023-08-04,"6","ATCO",1,0,1
"887","PLC202",2023,2023-08-04,"6","ERNA10",10,2,12
"888","PLC202",2023,2023-08-04,"6","ARTR2",10,2,12
"889","PLC202",2023,2023-08-04,"12","STEPH",1,1,2
"890","PLC202",2023,2023-08-04,"12","SATR12",1,0,1
"891","PLC202",2023,2023-08-04,"12","ATTO",7,6,13
"892","PLC202",2023,2023-08-04,"12","SPAI",2,0,2
"893","PLC202",2023,2023-08-04,"12","ARTR2",1,0,1
"894","PLC202",2023,2023-08-04,"7","ATTO",9,4,13
"895","PLC202",2023,2023-08-04,"7","ERIOG",9,0,9
"896","PLC202",2023,2023-08-04,"7","ARTR2",1,0,1
"897","PLC202",2023,2023-08-04,"7","SATR12",2,0,2
"898","PLC202",2023,2023-08-04,"7","ERNA10",1,0,1
"899","PLC202",2023,2023-08-04,"7","SPAI",1,0,1
"900","PLC202",2023,2023-08-04,"9","ATTO",2,0,2
"901","PLC202",2023,2023-08-04,"9","ARTR2",17,8,25
"902","PLC202",2023,2023-08-04,"9","SPAI",1,0,1
"903","PLC202",2023,2023-08-04,"9","ATCO",2,0,2
"904","PLC202",2023,2023-08-04,"9","TEGL",0,2,2
"905","PLC202",2023,2023-08-04,"10","ATTO",1,0,1
"906","PLC202",2023,2023-08-04,"10","ARTR2",15,11,26
"907","PLC202",2023,2023-08-04,"5","ATCO",8,3,11
"908","PLC202",2023,2023-08-04,"5","TEGL",0,3,3
"909","PLC202",2023,2023-08-04,"5","STEPH",1,0,1
"910","PLC202",2023,2023-08-04,"5","EPNE",1,0,1
"911","PLC202",2023,2023-08-04,"4","ARTR2",6,3,9
"912","PLC202",2023,2023-08-04,"4","ERNA10",7,3,10
"913","PLC202",2023,2023-08-04,"4","ATCO",3,3,6
"914","PLC202",2023,2023-08-04,"2","PSARM",1,2,3
"915","PLC202",2023,2023-08-04,"2","ATCO",2,3,5
"916","PLC202",2023,2023-08-04,"2","SPAI",40,0,40
"917","PLC202",2023,2023-08-04,"2","ERIOG",2,0,2
"918","PLC202",2023,2023-08-04,"2","ATTO",1,1,2
"919","PLC202",2023,2023-08-04,"8","DISP",1,0,1
"920","PLC202",2023,2023-08-04,"8","IVAX",11,0,11
"921","PLC202",2023,2023-08-04,"8","ELEOC",19,0,19
"922","PLC202",2023,2023-08-04,"8","ERNA10",0,2,2
"923","PLC202",2023,2023-08-04,"8","CEEX",2,0,2
"924","PLC202",2023,2023-08-04,"8","HEAN3",2,0,2
"925","PLC202",2023,2023-08-04,"8","BAHY",6,0,6
"926","PLC202",2023,2023-08-04,"8","HECU3",2,0,2
"927","PLC219",2023,2023-08-03,"1","ERIOG",16,0,16
"928","PLC219",2023,2023-08-03,"1","ATTO",4,1,5
"929","PLC219",2023,2023-08-03,"1","ATPO",4,1,5
"930","PLC219",2023,2023-08-03,"1","SATR12",1,0,1
"931","PLC219",2023,2023-08-03,"21","ATCO",1,1,2
"932","PLC219",2023,2023-08-03,"21","SAVE4",5,6,11
"933","PLC219",2023,2023-08-03,"23","SAVE4",6,7,13
"934","PLC219",2023,2023-08-03,"30","ATCO",2,0,2
"935","PLC219",2023,2023-08-03,"30","SAVE4",0,6,6
"936","PLC219",2023,2023-08-03,"10","ATCO",1,0,1
"937","PLC219",2023,2023-08-03,"10","SAVE4",9,6,15
"938","PLC219",2023,2023-08-03,"29","SAVE4",2,8,10
"939","PLC219",2023,2023-08-03,"29","ATCO",2,1,3
"940","PLC219",2023,2023-08-03,"17","SAVE4",4,4,8
"941","PLC219",2023,2023-08-03,"17","ATCO",1,1,2
"942","PLC219",2023,2023-08-03,"17","AMAC2",1,0,1
"943","PLC219",2023,2023-08-03,"17","STEPH",1,0,1
"944","PLC219",2023,2023-08-03,"17","ERNA10",1,0,1
"945","PLC219",2023,2023-08-03,"17","HECU3",4,0,4
"946","PLC219",2023,2023-08-03,"3","SPAI",6,0,6
"947","PLC219",2023,2023-08-03,"3","ATTO",18,7,25
"948","PLC219",2023,2023-08-03,"27","SAVE4",9,6,15
"949","PLC219",2023,2023-08-03,"27","ATCO",2,1,3
"950","PLC219",2023,2023-08-03,"27","ATPA3",1,0,1
"951","PLC219",2023,2023-08-03,"27","SUMO",1,0,1
"952","PLC219",2023,2023-08-03,"32","SAVE4",6,4,10
"953","PLC219",2023,2023-08-03,"32","ATCO",0,1,1
"954","PLC219",2023,2023-08-03,"32","SPAI",1,0,1
"955","PLC219",2023,2023-08-03,"32","ARTR2",1,0,1
"956","PLC219",2023,2023-08-03,"8","SPAI",7,4,11
"957","PLC219",2023,2023-08-03,"8","STEPH",3,0,3
"958","PLC219",2023,2023-08-03,"8","SAVE4",8,1,9
"959","PLC219",2023,2023-08-03,"14","SPAI",1,1,2
"960","PLC219",2023,2023-08-03,"14","ATCO",2,0,2
"961","PLC219",2023,2023-08-03,"14","STEPH",1,0,1
"962","PLC219",2023,2023-08-03,"14","SAVE4",7,10,17
"963","PLC219",2023,2023-08-03,"14","TEAX",1,0,1
"964","PLC219",2023,2023-08-03,"19","SAVE4",9,2,11
"965","PLC219",2023,2023-08-03,"19","PSARM",0,1,1
"966","PLC219",2023,2023-08-03,"19","ERNA10",4,2,6
"967","PLC219",2023,2023-08-03,"19","ATTO",0,1,1
"968","PLC219",2023,2023-08-03,"19","CORA5",2,0,2
"969","PLC219",2023,2023-08-03,"19","SUMO",1,0,1
"970","PLC219",2023,2023-08-03,"4","SAVE4",8,0,8
"971","PLC219",2023,2023-08-03,"4","ATPA3",4,1,5
"972","PLC219",2023,2023-08-03,"4","SUMO",2,0,2
"973","PLC219",2023,2023-08-03,"12","SAVE4",3,1,4
"974","PLC219",2023,2023-08-03,"12","ATPA3",0,1,1
"975","PLC219",2023,2023-08-03,"20","ATCO",4,3,7
"976","PLC219",2023,2023-08-03,"20","SUMO",7,2,9
"977","PLC219",2023,2023-08-03,"20","SAVE4",4,1,5
"978","PLC219",2023,2023-08-03,"20","ATTO",4,0,4
"979","PLC219",2023,2023-08-03,"23","ATCO",1,2,3
"980","PLC219",2023,2023-08-03,"23","SAVE4",8,3,11
"981","PLC219",2023,2023-08-03,"23","ERNA10",2,0,2
"982","PLC219",2023,2023-08-03,"23","STEPH",1,0,1
"983","PLC219",2023,2023-08-03,"5","SUMO",1,1,2
"984","PLC219",2023,2023-08-03,"5","SAVE4",6,6,12
"985","PLC219",2023,2023-08-03,"5","ERNA10",1,0,1
"986","PLC219",2023,2023-08-03,"5","STEPH",1,0,1
"987","PLC219",2023,2023-08-03,"5","SPAI",1,0,1
"988","PLC219",2023,2023-08-03,"2","SAVE4",2,0,2
"989","PLC219",2023,2023-08-03,"2","ATPA3",4,0,4
"990","PLC219",2023,2023-08-03,"9","SAVE4",10,2,12
"991","PLC219",2023,2023-08-03,"26","SAVE4",11,6,17
"992","PLC219",2023,2023-08-03,"26","SUMO",1,0,1
"993","PLC219",2023,2023-08-03,"26","ATCO",3,0,3
"994","PLC219",2023,2023-08-03,"26","STEPH",0,1,1
"995","PLC219",2023,2023-08-03,"15","SAVE4",3,5,8
"996","PLC219",2023,2023-08-03,"15","SUMO",2,2,4
"997","PLC219",2023,2023-08-03,"15","ATCO",6,5,11
"998","PLC219",2023,2023-08-03,"15","STEPH",0,1,1
"999","PLC219",2023,2023-08-03,"15","SPAI",4,3,7
"1000","PLC219",2023,2023-08-03,"22","STEPH",1,0,1
"1001","PLC219",2023,2023-08-03,"22","SPAI",14,2,16
"1002","PLC219",2023,2023-08-03,"22","ERNA10",3,0,3
"1003","PLC219",2023,2023-08-03,"7","SAVE4",3,2,5
"1004","PLC219",2023,2023-08-03,"7","SPAI",3,0,3
"1005","PLC219",2023,2023-08-03,"7","ERNA10",12,2,14
"1006","PLC219",2023,2023-08-03,"6","SAVE4",10,5,15
"1007","PLC219",2023,2023-08-03,"6","ATPA3",2,1,3
"1008","PLC219",2023,2023-08-03,"11","SAVE4",7,5,12
"1009","PLC219",2023,2023-08-03,"11","ATCO",1,0,1
"1010","PLC219",2023,2023-08-03,"11","SUMO",0,1,1
"1011","PLC219",2023,2023-08-03,"31","SAVE4",2,4,6
"1012","PLC219",2023,2023-08-03,"31","SUMO",7,2,9
"1013","PLC219",2023,2023-08-03,"18","SAVE4",4,6,10
"1014","PLC219",2023,2023-08-03,"18","ATCO",5,1,6
"1015","PLC219",2023,2023-08-03,"18","SUMO",3,0,3
"1016","PLC219",2023,2023-08-03,"28","SAVE4",8,3,11
"1017","PLC219",2023,2023-08-03,"16","SAVE4",3,1,4
"1018","PLC219",2023,2023-08-03,"16","ATPA3",1,0,1
"1019","PLC219",2023,2023-08-03,"16","TEGL",1,0,1
"1020","PLC227",2023,2023-07-29,"16","ATCO",13,4,17
"1021","PLC227",2023,2023-07-29,"16","SATR12",4,0,4
"1022","PLC227",2023,2023-07-29,"16","ACHY",1,0,1
"1023","PLC227",2023,2023-07-29,"16","ERIOG",1,0,1
"1024","PLC227",2023,2023-07-29,"29","ATCO",3,2,5
"1025","PLC227",2023,2023-07-29,"29","SATR12",1,0,1
"1026","PLC227",2023,2023-07-29,"29","PSPO",2,3,5
"1027","PLC227",2023,2023-07-29,"29","ERNA10",1,0,1
"1028","PLC227",2023,2023-07-29,"29","ATCA2",2,1,3
"1029","PLC227",2023,2023-07-29,"30","ATCO",3,1,4
"1030","PLC227",2023,2023-07-29,"30","PSPO",2,1,3
"1031","PLC227",2023,2023-07-29,"30","SATR12",1,0,1
"1032","PLC227",2023,2023-07-29,"30","ERNA10",7,2,9
"1033","PLC227",2023,2023-07-29,"30","ATCA2",4,0,4
"1034","PLC227",2023,2023-07-29,"15","ATCO",5,5,10
"1035","PLC227",2023,2023-07-29,"15","ACHY",1,0,1
"1036","PLC227",2023,2023-07-29,"15","ATCA2",3,0,3
"1037","PLC227",2023,2023-07-29,"13","ATCO",1,0,1
"1038","PLC227",2023,2023-07-29,"13","ERIOG",2,0,2
"1039","PLC227",2023,2023-07-29,"13","PSPO",0,1,1
"1040","PLC227",2023,2023-07-29,"13","ERNA10",2,0,2
"1041","PLC227",2023,2023-07-29,"13","ATCA2",11,2,13
"1042","PLC227",2023,2023-07-29,"13","SAVE4",6,1,7
"1043","PLC227",2023,2023-07-29,"13","CALI4",0,1,1
"1044","PLC227",2023,2023-07-29,"13","STEPH",1,0,1
"1045","PLC227",2023,2023-07-29,"25","ATCO",6,0,6
"1046","PLC227",2023,2023-07-29,"12","ATCO",10,2,12
"1047","PLC227",2023,2023-07-29,"18","ATCO",10,3,13
"1048","PLC227",2023,2023-07-29,"24","ATCO",5,0,5
"1049","PLC227",2023,2023-07-29,"24","ATCA2",3,1,4
"1050","PLC227",2023,2023-07-29,"1","ATCO",5,1,6
"1051","PLC227",2023,2023-07-29,"1","ATCA2",5,0,5
"1052","PLC227",2023,2023-07-29,"1","CALI4",1,0,1
"1053","PLC227",2023,2023-07-29,"1","ERNA10",1,0,1
"1054","PLC227",2023,2023-07-29,"7","ATCA2",6,2,8
"1055","PLC227",2023,2023-07-29,"7","ERNA10",1,0,1
"1056","PLC227",2023,2023-07-29,"7","SATR12",9,2,11
"1057","PLC227",2023,2023-07-29,"7","ATTO",1,1,2
"1058","PLC227",2023,2023-07-29,"4","ATCA2",3,3,6
"1059","PLC227",2023,2023-07-29,"4","ATCO",2,0,2
"1060","PLC227",2023,2023-07-29,"4","PSARM",1,1,2
"1061","PLC227",2023,2023-07-29,"10","ATCA2",8,2,10
"1062","PLC227",2023,2023-07-29,"10","ERIOG",2,0,2
"1063","PLC227",2023,2023-07-29,"10","PSPO",6,6,12
"1064","PLC227",2023,2023-07-29,"31","PSARM",1,0,1
"1065","PLC227",2023,2023-07-29,"31","SPAI",1,0,1
"1066","PLC227",2023,2023-07-29,"31","ATPO",3,1,4
"1067","PLC227",2023,2023-07-29,"5","ATCA2",0,1,1
"1068","PLC227",2023,2023-07-29,"5","SPAI",1,0,1
"1069","PLC227",2023,2023-07-29,"5","ATPO",11,1,12
"1070","PLC227",2023,2023-07-29,"22","ATCA2",9,0,9
"1071","PLC227",2023,2023-07-29,"22","PSPO",1,1,2
"1072","PLC227",2023,2023-07-29,"22","ATCO",2,0,2
"1073","PLC227",2023,2023-07-29,"22","ERIOG",1,0,1
"1074","PLC227",2023,2023-07-29,"17","ATCA2",7,2,9
"1075","PLC227",2023,2023-07-29,"17","PSPO",4,3,7
"1076","PLC227",2023,2023-07-29,"17","ATCO",0,2,2
"1077","PLC227",2023,2023-07-29,"2","SATR12",56,2,58
"1078","PLC227",2023,2023-07-29,"2","ATPO",1,0,1
"1079","PLC227",2023,2023-07-29,"2","ATTO",2,0,2
"1080","PLC227",2023,2023-07-29,"11","ATCA2",6,1,7
"1081","PLC227",2023,2023-07-29,"11","PSPO",0,1,1
"1082","PLC227",2023,2023-07-29,"11","ATCO",4,0,4
"1083","PLC227",2023,2023-07-29,"11","SATR12",1,0,1
"1084","PLC227",2023,2023-07-29,"11","SAVE4",7,4,11
"1085","PLC227",2023,2023-07-29,"11","STEPH",1,0,1
"1086","PLC227",2023,2023-07-29,"3","ATCA2",6,5,11
"1087","PLC227",2023,2023-07-29,"3","PSPO",0,2,2
"1088","PLC227",2023,2023-07-29,"3","ATCO",7,5,12
"1089","PLC227",2023,2023-07-29,"3","SATR12",3,0,3
"1090","PLC227",2023,2023-07-29,"28","ATCO",2,0,2
"1091","PLC227",2023,2023-07-29,"28","PSARM",0,2,2
"1092","PLC227",2023,2023-07-29,"28","ATCA2",5,1,6
"1093","PLC227",2023,2023-07-29,"28","PSPO",4,5,9
"1094","PLC227",2023,2023-07-29,"19","PSARM",0,1,1
"1095","PLC227",2023,2023-07-29,"19","ATCA2",8,1,9
"1096","PLC227",2023,2023-07-29,"19","PSPO",4,3,7
"1097","PLC227",2023,2023-07-29,"14","ATCA2",12,3,15
"1098","PLC227",2023,2023-07-29,"14","PSPO",3,1,4
"1099","PLC227",2023,2023-07-29,"23","ATCA2",11,1,12
"1100","PLC227",2023,2023-07-29,"23","PSPO",3,3,6
"1101","PLC227",2023,2023-07-29,"23","ERNA10",1,0,1
"1102","PLC227",2023,2023-07-29,"8","ATCA2",15,3,18
"1103","PLC227",2023,2023-07-29,"8","PSPO",3,3,6
"1104","PLC227",2023,2023-07-29,"8","ERNA10",1,0,1
"1105","PLC227",2023,2023-07-29,"8","ERIOG",1,0,1
"1106","PLC227",2023,2023-07-29,"26","ATCA2",3,2,5
"1107","PLC227",2023,2023-07-29,"26","ERIOG",2,0,2
"1108","PLC227",2023,2023-07-29,"26","SATR12",3,1,4
"1109","PLC227",2023,2023-07-29,"32","ATCA2",16,2,18
"1110","PLC227",2023,2023-07-29,"32","ERIOG",4,0,4
"1111","PLC227",2023,2023-07-29,"32","ERNA10",1,0,1
"1112","PLC227",2023,2023-07-29,"20","ATCA2",7,3,10
"1113","PLC227",2023,2023-07-29,"20","SATR12",4,6,10
"1114","PLC227",2023,2023-07-29,"21","ATCA2",6,6,12
"1115","PLC227",2023,2023-07-29,"21","SATR12",0,2,2
"1116","PLC227",2023,2023-07-29,"21","ATTO",2,1,3
"1117","PLC227",2023,2023-07-29,"21","STEPH",2,0,2
"1118","PLC227",2023,2023-07-29,"27","ATCA2",3,3,6
"1119","PLC227",2023,2023-07-29,"27","ERNA10",12,4,16
"1120","PLC227",2023,2023-07-29,"6","ATPO",2,0,2
"1121","PLC227",2023,2023-07-29,"6","ATCA2",9,2,11
"1122","PLC227",2023,2023-07-29,"6","ERIOG",3,0,3
"1123","PLC227",2023,2023-07-29,"6","SATR12",1,0,1
"1124","PLC227",2023,2023-07-29,"9","ATPO",0,1,1
"1125","PLC227",2023,2023-07-29,"9","ATCA2",4,1,5
"1126","PLC227",2023,2023-07-29,"9","ERNA10",6,1,7
"1127","PLC227",2023,2023-07-29,"9","PSARM",1,0,1
"1128","PLC230",2023,2023-07-28,"31","ATPO",17,7,24
"1129","PLC230",2023,2023-07-28,"6","ATPO",19,3,22
"1130","PLC230",2023,2023-07-28,"6","SATR12",3,0,3
"1131","PLC230",2023,2023-07-28,"6","ATCA2",3,0,3
"1132","PLC230",2023,2023-07-28,"5","ATPO",21,4,25
"1133","PLC230",2023,2023-07-28,"5","SATR12",7,0,7
"1134","PLC230",2023,2023-07-28,"5","ATTO",1,1,2
"1135","PLC230",2023,2023-07-28,"1","ATPO",26,4,30
"1136","PLC230",2023,2023-07-28,"1","SATR12",3,0,3
"1137","PLC230",2023,2023-07-28,"14","SATR12",30,0,30
"1138","PLC230",2023,2023-07-28,"14","ATTO",2,1,3
"1139","PLC230",2023,2023-07-28,"3","SATR12",33,4,37
"1140","PLC230",2023,2023-07-28,"3","ATTO",1,0,1
"1141","PLC230",2023,2023-07-28,"28","SATR12",3,0,3
"1142","PLC230",2023,2023-07-28,"28","ATTO",4,0,4
"1143","PLC230",2023,2023-07-28,"28","ERIOG",8,0,8
"1144","PLC230",2023,2023-07-28,"7","ATTO",2,0,2
"1145","PLC230",2023,2023-07-28,"7","SPAI",32,0,32
"1146","PLC230",2023,2023-07-28,"7","ALOC2",1,0,1
"1147","PLC230",2023,2023-07-28,"7","ERNA10",0,3,3
"1148","PLC230",2023,2023-07-28,"24","SATR12",2,0,2
"1149","PLC230",2023,2023-07-28,"24","ATTO",18,1,19
"1150","PLC230",2023,2023-07-28,"24","SPAI",2,0,2
"1151","PLC230",2023,2023-07-28,"24","MALE3",1,0,1
"1152","PLC230",2023,2023-07-28,"21","SATR12",19,1,20
"1153","PLC230",2023,2023-07-28,"21","ATTO",17,2,19
"1154","PLC230",2023,2023-07-28,"21","MALE3",3,0,3
"1155","PLC230",2023,2023-07-28,"25","ATTO",14,0,14
"1156","PLC230",2023,2023-07-28,"25","SATR12",6,3,9
"1157","PLC230",2023,2023-07-28,"25","SPAI",1,0,1
"1158","PLC230",2023,2023-07-28,"25","ERNA10",0,1,1
"1159","PLC230",2023,2023-07-28,"35","ATTO",17,3,20
"1160","PLC230",2023,2023-07-28,"35","SATR12",1,0,1
"1161","PLC230",2023,2023-07-28,"35","ERNA10",1,0,1
"1162","PLC230",2023,2023-07-28,"8","SATR12",14,3,17
"1163","PLC230",2023,2023-07-28,"8","ATCA2",13,0,13
"1164","PLC230",2023,2023-07-28,"8","ACHY",0,1,1
"1165","PLC230",2023,2023-07-28,"8","ERIOG",2,0,2
"1166","PLC230",2023,2023-07-28,"2","ATTO",4,0,4
"1167","PLC230",2023,2023-07-28,"2","SATR12",1,0,1
"1168","PLC230",2023,2023-07-28,"2","SPAI",4,0,4
"1169","PLC230",2023,2023-07-28,"2","ATCO",0,2,2
"1170","PLC230",2023,2023-07-28,"2","ATPO",3,0,3
"1171","PLC230",2023,2023-07-28,"29","ATTO",6,1,7
"1172","PLC230",2023,2023-07-28,"29","SPAI",14,0,14
"1173","PLC230",2023,2023-07-28,"12","ATTO",11,2,13
"1174","PLC230",2023,2023-07-28,"12","SATR12",56,0,56
"1175","PLC230",2023,2023-07-28,"23","ATTO",11,1,12
"1176","PLC230",2023,2023-07-28,"23","SATR12",4,0,4
"1177","PLC230",2023,2023-07-28,"23","SPAI",8,0,8
"1178","PLC230",2023,2023-07-28,"23","ERNA10",0,1,1
"1179","PLC230",2023,2023-07-28,"23","ERIOG",1,1,2
"1180","PLC230",2023,2023-07-28,"23","MALE3",1,0,1
"1181","PLC230",2023,2023-07-28,"18","ATTO",14,4,18
"1182","PLC230",2023,2023-07-28,"18","SATR12",8,0,8
"1183","PLC230",2023,2023-07-28,"18","SPAI",11,0,11
"1184","PLC230",2023,2023-07-28,"18","ERIOG",1,0,1
"1185","PLC230",2023,2023-07-28,"18","MALE3",3,0,3
"1186","PLC230",2023,2023-07-28,"30","SATR12",2,0,2
"1187","PLC230",2023,2023-07-28,"30","ATPO",24,2,26
"1188","PLC230",2023,2023-07-28,"27","ATPO",16,6,22
"1189","PLC230",2023,2023-07-28,"27","ATCA2",2,1,3
"1190","PLC230",2023,2023-07-28,"38","ATPO",14,6,20
"1191","PLC230",2023,2023-07-28,"4","ATPO",11,5,16
"1192","PLC230",2023,2023-07-28,"17","ATPO",18,4,22
"1193","PLC230",2023,2023-07-28,"26","ATPO",17,5,22
"1194","PLC230",2023,2023-07-28,"33","ATCA2",13,1,14
"1195","PLC230",2023,2023-07-28,"33","ERNA10",2,1,3
"1196","PLC230",2023,2023-07-28,"33","SAVE4",3,0,3
"1197","PLC230",2023,2023-07-28,"33","ERIOG",1,0,1
"1198","PLC230",2023,2023-07-28,"33","ACHY",0,2,2
"1199","PLC230",2023,2023-07-28,"9","ATPO",20,6,26
"1200","PLC230",2023,2023-07-28,"19","SATR12",4,0,4
"1201","PLC230",2023,2023-07-28,"19","ATCA2",5,2,7
"1202","PLC230",2023,2023-07-28,"19","ERIOG",7,0,7
"1203","PLC230",2023,2023-07-28,"22","SATR12",1,1,2
"1204","PLC230",2023,2023-07-28,"22","ATCA2",15,0,15
"1205","PLC230",2023,2023-07-28,"22","STEPH",1,0,1
"1206","PLC230",2023,2023-07-28,"13","ATCA2",4,0,4
"1207","PLC230",2023,2023-07-28,"13","PSPO",3,0,3
"1208","PLC230",2023,2023-07-28,"13","ACHY",0,1,1
"1209","PLC230",2023,2023-07-28,"13","STEPH",1,0,1
"1210","PLC230",2023,2023-07-28,"15","ATTO",8,3,11
"1211","PLC230",2023,2023-07-28,"15","SPAI",2,0,2
"1212","PLC230",2023,2023-07-28,"15","ERNA10",2,1,3
"1213","PLC230",2023,2023-07-28,"40","ATTO",8,2,10
"1214","PLC230",2023,2023-07-28,"40","SATR12",12,7,19
"1215","PLC230",2023,2023-07-28,"11","ATTO",4,1,5
"1216","PLC230",2023,2023-07-28,"11","SATR12",13,3,16
"1217","PLC230",2023,2023-07-28,"11","SPAI",1,0,1
"1218","PLC230",2023,2023-07-28,"37","ATTO",4,3,7
"1219","PLC230",2023,2023-07-28,"37","SATR12",28,1,29
"1220","PLC230",2023,2023-07-28,"10","ATTO",5,1,6
"1221","PLC230",2023,2023-07-28,"10","SATR12",1,0,1
"1222","PLC230",2023,2023-07-28,"10","MALE3",1,0,1
"1223","PLC230",2023,2023-07-28,"10","ERIOG",1,0,1
"1224","PLC230",2023,2023-07-28,"10","ATPO",2,0,2
"1225","PLC230",2023,2023-07-28,"36","ATTO",4,0,4
"1226","PLC230",2023,2023-07-28,"36","SATR12",6,0,6
"1227","PLC230",2023,2023-07-28,"36","ERIOG",7,0,7
"1228","PLC230",2023,2023-07-28,"16","SATR12",10,4,14
"1229","PLC230",2023,2023-07-28,"16","ATTO",2,0,2
"1230","PLC230",2023,2023-07-28,"39","SATR12",0,1,1
"1231","PLC230",2023,2023-07-28,"39","ATTO",1,1,2
"1232","PLC230",2023,2023-07-28,"39","ATPO",10,7,17
"1233","PLC230",2023,2023-07-28,"39","ATCA2",1,0,1
"1234","PLC230",2023,2023-07-28,"32","ATTO",1,0,1
"1235","PLC230",2023,2023-07-28,"32","ATPO",12,5,17
"1236","PLC230",2023,2023-07-28,"34","ATPO",2,0,2
"1237","PLC230",2023,2023-07-28,"20","ATPO",5,0,5
"1238","PLC230",2023,2023-07-28,"20","ATCA2",3,0,3
"1239","PLC230",2023,2023-07-28,"20","ATTO",0,1,1
